1111111111111
1C110000000C1
1000011111001
1P00110E00001
1111111111111